33
16
8
images/ground.png 1 2
images/wall.png 1 2
images/grass.png 1 1
images/marble.png 1 2 4
images/marble2.png 1 2 4
images/flower.png 1 0
images/flower2.png 1 0
images/coin.png 20 0 8
1 1 1 1 1 1 1 1 1 1 1 1 1 1 1 1 1 1 1 1 1 1 1 1 1 1 1 1 1 1 1 1 0 
1 4 2 2 2 2 4 4 2 2 0 4 4 2 2 0 2 4 1 1 3 3 4 4 4 4 4 4 4 4 4 4 0 
1 4 4 2 2 2 2 2 0 0 0 0 4 4 2 0 4 4 1 1 1 3 4 4 4 4 4 4 4 4 4 4 0 
1 2 2 2 2 2 2 0 0 0 0 0 0 2 2 0 0 0 1 1 1 2 2 2 2 0 0 4 4 4 4 4 0 
1 -1 -1 5 -1 -1 6 -1 -1 -1 -1 -1 -1 5 6 -1 -1 -1 4 -1 5 -1 -1 6 -1 -1 0 1 7 7 7 7 1 
1 -1 -1 -1 -1 -1 -1 -1 -1 -1 -1 -1 -1 -1 -1 -1 -1 -1 4 -1 -1 -1 -1 -1 -1 -1 0 1 7 -1 -1 7 1 
1 -1 -1 -1 -1 -1 -1 -1 -1 -1 1 1 1 1 -1 -1 -1 -1 1 1 1 1 1 0 2 2 0 1 1 3 3 1 1 
1 -1 -1 -1 -1 -1 -1 -1 -1 -1 -1 7 7 -1 -1 -1 -1 1 1 7 7 7 0 0 6 -1 0 0 3 3 3 3 1 
1 -1 -1 -1 -1 -1 -1 -1 -1 -1 -1 -1 -1 -1 -1 -1 7 1 1 7 7 7 -1 -1 -1 -1 -1 -1 -1 -1 -1 -1 1 
1 -1 -1 -1 -1 -1 -1 -1 -1 -1 -1 -1 -1 -1 -1 1 1 1 1 1 -1 -1 -1 -1 -1 -1 -1 -1 -1 -1 -1 -1 1 
1 -1 -1 -1 1 1 1 -1 -1 -1 -1 -1 -1 -1 -1 -1 -1 7 1 1 1 -1 -1 -1 -1 -1 -1 -1 -1 -1 -1 -1 1 
1 -1 -1 1 1 1 -1 -1 -1 -1 -1 -1 -1 -1 -1 -1 -1 -1 -1 1 1 1 1 1 1 1 1 1 1 1 1 1 1 
1 -1 -1 7 7 4 -1 -1 -1 -1 -1 -1 -1 -1 -1 -1 -1 -1 -1 7 -1 -1 7 -1 -1 7 -1 -1 7 -1 -1 7 1 
1 -1 -1 7 7 4 -1 -1 -1 -1 -1 -1 -1 -1 -1 -1 -1 -1 -1 -1 -1 -1 -1 -1 -1 -1 -1 -1 -1 -1 -1 7 1 
1 -1 -1 7 7 4 -1 -1 -1 -1 -1 -1 -1 -1 -1 -1 -1 -1 -1 -1 -1 -1 -1 -1 -1 -1 -1 -1 -1 -1 -1 -1 1 
1 -1 -1 -1 -1 -1 -1 -1 -1 -1 -1 -1 -1 -1 -1 -1 -1 -1 -1 -1 -1 -1 -1 -1 -1 -1 -1 -1 -1 -1 -1 -1 1 
